NO img/north2.xpm



SO img/south2.xpm


WE img/west2.xpm



EA img/east2.xpm



F 0,0,0
C 225,225,0


1111111111111111111111111
1N0000000001000000000001
101100000111000000000001
1001000000000000000000001
1111111110110000011100001
100000000011000001110111111111111
11110111111111011100000010001
11110111111111011101010010001
11000000110101011100000010001
10000000000000001100000010001
10000000000000001101010010001
1100000111010101111101111000111
11110111 1110101 101111010001
11111111 1111111 111111111111
